2 0 0 1 1 1 1 6 3 1
0 1 0 1 1 1 1 5 0 1
0 1 0 0 0 0 0 0 0 1
0 1 1 1 0 1 1 1 0 1
7 1 1 1 0 1 1 1 0 1
9 1 1 0 0 7 4 1 0 1
1 0 0 0 1 1 1 1 5 1
1 5 1 0 1 1 1 1 3 1
1 8 7 0 0 0 4 1 8 1
1 1 1 1 1 1 1 1 1 1