2 1 1 1 0 0 0 0 1 1
0 1 1 1 0 0 1 0 1 4
0 0 0 1 1 0 1 0 1 0
0 1 0 0 0 0 1 0 0 0
0 1 5 5 1 1 1 5 5 5
0 3 0 0 0 0 1 0 8 0
3 1 3 1 1 5 1 1 3 3
0 1 0 0 0 0 0 5 0 0
6 1 0 0 0 0 0 1 0 7
0 1 0 0 0 0 0 1 7 9