2 1 1 1 1 1 1 1 1 1
0 0 0 0 0 0 1 4 0 1
1 1 1 1 1 0 1 1 0 1
1 1 8 5 3 0 0 0 0 1
1 1 1 1 1 3 1 1 1 1
1 0 0 5 0 0 0 1 6 1
1 0 1 1 1 1 0 0 0 1
1 0 1 1 1 1 0 1 0 1
1 9 0 5 3 0 0 0 0 1
1 1 1 1 1 1 1 1 1 1